1 1 1 2 2 2 3 3 3 4
0 0 1 2 0 2 3 0 3 4
0 0 1 2 0 2 3 0 3 4
1 1 1 2 0 2 3 3 3 4
0 0 1 2 0 2 3 0 3 4
0 0 1 2 0 2 3 0 3 4
1 1 1 2 2 2 3 3 3 10
0 0 0 0 0 0 0 0 0 0
7 0 0 0 5 6 0 0 0 7
8 0 0 0 5 5 0 0 0 8
0 0 0 0 0 0 0 0 0 0
0 0 0 0 0 0 0 0 0 0
0 9 0 0 0 0 0 0 9 0

