0 0 3 3 7 7 3 3 0 0
0 0 0 2 5 5 2 0 0 0
0 0 0 0 4 4 0 0 0 0
0 0 0 0 0 0 0 0 0 0
0 0 0 0 0 0 0 0 0 0
4 2 2 0 8 8 0 2 2 4
9 10 10 9 9 9 9 10 10 9
1 0 0 1 6 7 1 0 0 1
0 2 2 0 0 0 0 2 2 0