4 4 3 10 3 3 10 3 4 4
10 2 2 2 2 2 2 2 2 10
1 1 1 1 1 1 1 1 1 1
0 0 0 0 0 0 0 0 0 0
0 0 0 0 0 0 0 0 0 0
0 0 0 0 0 0 0 0 0 0
0 0 0 0 0 0 0 0 0 0
9 0 4 0 9 9 0 4 0 9
