0 0 0 1 2 2 1 0 0 0
0 0 1 3 10 10 3 1 0 0
0 1 0 0 0 0 0 0 1 0
1 4 0 0 1 1 0 0 4 1
1 10 0 1 7 8 1 0 10 1
1 4 0 1 6 5 1 0 4 1
1 1 0 0 1 1 0 0 1 1
0 1 0 0 0 0 0 0 1 0
0 0 0 0 0 0 0 0 0 0
0 0 0 0 0 0 0 0 0 0
0 0 0 0 0 0 0 0 0 0
9 0 9 0 0 0 0 9 0 9